.........................................................................................................................................................................@-------+=..................................................................................
.::::::::::::::::::::::::::::::::::::::::::::::::::::::::::::::::::::::::::::::::::::::::::::::::::::::::::::::::::::::::::::::::::::::::::::::::::::::::::::::::::::::..@%%%%%%%@@.::::::::::::::::::::::::::::::::::::::::::::::::::::::::::::::::::::::::::::::::.
.::::::::::::::::::::::::::::::::::::::::::::::::::::::::::::::::::::::::::::::::::::::::::::::::::::::::::::::::::::::::::::::::::::::::::::::::::::::::::::::::::::::..@%%@@@%%@@.::::::::::::::::::::::::::::::::::::::::::::::::::::::::::::::::::::::::::::::::.
.::::::::::::::::::::::::::::::::::::::::::::::::::::::::::::::::::......::::::::::::::::::::::::::::::::::::::::::::::::::::::::::::::::::::::::::::::::::::::::::::::..@%%@.@%%@@.::::::::::::::::::::::::::::::::::::::::::::::::::::::::::::::::::::::::::::::::.
.:::::::::::::::::::::::::::::::::::::::::::::::::::::::::::::::::...@@@...::::::::::::::::::::::::::::::::::::::::::::::::::::::::::::::::::::::::::::::::::::::::::::..@%%@.@%%@@.::::::::::::::::::::::::::::::::::::::::::::::::::::::::::::::::::::::::::::::::.
.:::::::::::::::::::::::::::::::::::::::::::::::::::::::::::::::...@%%@#@+...::::::::::::::::::::::::::::::::::::::::::::::::::::::::::::::::::::::::::::::::::::::::::..@%%@.@%%@@.::::::::::::::::::::::::::::::::::::::::::::::::::::::::::::::::::::::::::::::::.
.:::::::::::::::::::::::::::::::::::::::::::::::::::::::::::::...@@%@@:@@%@:..:::::::::::::::::::::::::::::::::::::::::::::::::::::::::::::::::::::::::::::::::::::::::..@%%@.@%%@@.::::::::::::::::::::::::::::::::::::::::::::::::::::::::::::::::::::::::::::::::.
.:::::::::::::::::::::::::::::::::::::::::::::::::::::::::::...@@#@@....=@@%@...:::::::::::::::::::::::::::::::::::::::::::::::::::::::::::::::::::::::::::::::::::::::..@%%@.@%%@@.::::::::::::::::::::::::::::::::::::::::::::::::::::::::::::::::::::::::::::::::.
.:::::::::::::::::::::::::::::::::::::::::::::::::::::::::...:@%@@........@@%%@...:::::::::::::::::::::::::::::::::::::::::::::::::::::::::::::::::::::::::::::::::::::..@%%@.@%%@@.::::::::::::::::::::::::::::::::::::::::::::::::::::::::::::::::::::::::::::::::.
.::::::::::::::::::::::::::::::::::::::::::::::::::::::::...@%@@-..@@@@@@*..@@%%@...:::::::::::::::::::::::::::::::::::::::::::::::::::::::::::::::::::::::::::::::::::..@%%@@@%%@@.::::::::::::::::::::::::::::::::::::::::::::::::::::::::::::::::::::::::::::::::.
.::::::::::::::::::::::::::::::::::::::::::::::::::::::...@%%@%.:=.@..@.%#--..@@#@@...:::::::::::::::::::::::::::::::::::::::::::::::::::::::::::::::::::::::::::::::::..@%%%%%%%@@.::::::::::::::::::::::::::::::::::::::::::::::::::::::::::::::::::::::::::::::::.
.::::::::::::::::::::::::::::::::::::::::::::::::::::...@%%@@.:=++:@..@.@%-++:.:@@#@:...:::::::::::::::::::::::::::::::::::::::::::::::::::::::::::::::::::::::::::::::..@%%%%%%%@@.::::::::::::::::::::::::::::::::::::::::::::::::::::::::::::::::::::::::::::::::.
.:::::::::::::::::::::::::::::::::::::::::::::::::::..@@@@@::=****=@@@@@@%+****-:*@@@@=...:::::::::::::::::::::::::::::::::::::::::::::::::::::::::::::::::::::::::::::..@%%@@@%%@@.::::::::::::::::::::::::::::::::::::::::::::::::::::::::::::::::::::::::::::::::.
.:::::::::::::::::::::::::::::::::::::::::::::::::::.@:#--+#@@@@@@@%#*###%@@@@@@@*=:@.+*@.:::::::::::::::::::::::::::::::::::::::::::::::::::::::::::::::::::::::::::::..@%%@.@%%@@.::::::::::::::::::::::::::::::::::::::::::::::::::::::::::::::::::::::::::::::::.
.:::::::::::::::::::::::::::::::::::::::::::::::::::...%............................@.....:::::::::::::::::::::::::::::::::::::::::::::::::::::::::::::::::::::::::::::..@%%@.@%%@@.::::::::::::::::::::::::::::::::::::::::::::::::::::::::::::::::::::::::::::::::.
.:::::::::::::::::::::::::::::::::::::::::::::::::::::.@.:............::..........:.@:-.:::::::::::::::::::::::::::::::::::::::::::::::::::::::::::::::::::::::::::::::..@%%@.@%%@@.::::::::::::::::::::::::::::::::::::::::::::::::::::::::::::::::::::::::::::::::.
.:::::::::::::::::::::::::::::::::::::::::::::::::::::.@.:.@@@@@@@@@@.::.@@@@@@@@.:.@:-.:::::::::::::::::::::::::::::::::::::::::::::::::::::::::::::::::::::::::::::::..@%%@.@%%@@.::::::::::::::::::::::::::::::::::::::::::::::::::::::::::::::::::::::::::::::::.
.:::::::::::::::::::::::::::::::::::::::::::::::::::::.@.:.@%......@@.::.@..@..%%.:.@:-.:::::::::::::::::::::::::::::::::::::::::::::::::::::::::::::::::::::::::::::::..@%%@.@%%@@.::::::::::::::::::::::::::::::::::::::::::::::::::::::::::::::::::::::::::::::::.
.:::::::::::::::::::::::::::::::::::::::::::::::::::::.@.:.@@@@@@@@@@.::.@%:@#+@@.:.@:-.:::::::::::::::::::::::::::::::::::::::::::::::::::::::::::::::::::::::::::::::..@%%@.@%%@@.::::::::::::::::::::::::::::::::::::::::::::::::::::::::::::::::::::::::::::::::.
.:::::::::::::::::::::::::::::::::::::::::::::::::::::.@.:.@%=+++-+@@.::.@:.@..@@.:.@:-.:::::::::::::::::::::::::::::::::::::::::::::::::::::::::::::::::::::::::::::::..@%%@@@%%@@.::::::::::::::::::::::::::::::::::::::::::::::::::::::::::::::::::::::::::::::::.
.:::::::::::::::::::::::::::::::::::::::::::::::::::::.@.:.@%+**#-*@@.::.#******-.:.@:-.:::::::::::::::::::::::::::::::::::::::::::::::::::::::::::::::::::::::::::::::..@%%%%%%%@@.::::::::::::::::::::::::::::::::::::::::::::::::::::::::::::::::::::::::::::::::.
.:::::::::::::::::::::::::::::::::::::::::::::::::::::.@.:.@%+****=@@.::.........::.@:-.:::::::::::::::::::::::::::::::::::::::::::::::::::::::::::::::::::::::::::::::..@%%%%%%%@@.::::::::::::::::::::::::::::::::::::::::::::::....::::::::::::::::::::::::::::::.
.:::::::::::::::::::::::::::::::::::::::::::::::::::::.@.:.@%+****=@@.:::::::::::::.@:-.:::::::::::::::::::::::::::::::::::::::::::::::::::::::::::::::::::::::::::::::..@%%@@@%%@@.::::::::::::::::::::::::::::::::::::::::::::...--...::::::::::::::::::::::::::::.
.:::::::::::::::::::::::::::::::::::::::::::::::::::::.@...@@@@@@@@@@...............@::.:::::::::::::::::::::::::::::::::::::::::::::::::::::::::::::::::::::::::::::::..@%%@.@%%@@.:::::::::::::::::::::::::::::::::::::::::....@@@@@@....:::::::::::::::::::::::::.
.:::::::::::::::::::::::::::::::::::::::::::::::::::::.-@@@+::::::::+@@@@@@@@@@@@@@@%@.::::::::::::::::::::::::::::::::::::::::::::::::::::::::::::::::::::::::::::::::..@%%@.@%%@@.::::::::::::::::::::::::::::::::::::::::...@#%@-:@%*@....:::::::::::::::::::::::.
.::::::::::::::::::::::::::::::::::::::::::::::::::::::................................::::::::::::::::::::::::::::::::::::::::::::::::::::::::::::::::::::::::::::::::..@%%@.@%%@@.:::::::::::::::::::::::::::::::::::......@+@@.:..:.@@-@......:::::::::::::::::::.
.::::::::::::::::::::::::::::::::::::::::::::::::::::::::::::::::::::::::::::::::::::::::::::::::::::::::::::::::::::::::::::::::::::::::::::::::::::::::::::::::::::::..@%%@.@%%@@.:::::::::::::::::::::::::::::::::::..@@%:@.:........:.@=#@@..:::::::::::::::::::.
.........................................................................................................................................................................@%%@.@%%@@.::::::::::::::::::::::::::::::::....@+@@@@....-@@%....@@@@=@....::::::::::::::::.
.@@@@@@@@@@@@@@@@@@@@@@@@@@@@@@@@@@@@@@@@@@@@@@@@@@@@@@@@@@@@@@@@@@@@@@@@@@@@@@@@@@@@@@@@@@@@@@@@@@@@@@@@@@@@@@@@@@@@@@@@@@@@@@@@@@@@@@@@@@@@@@@@@@@@@@@@@@@@@@@@@@@@@@@*@%%@.@%%@@.:::::::::::::::::::::::::::......+@%*@...@..+@@@@@@@..@-..@=%@=......:::::::::::.
#@@@@@@@@@@@@@@@@@@@@@@@@@@@@@@@@@@@@@@@@@@@@@@@@@@@@@@@@@@@@@@@@@@@@@@@@@@@@@@@@@@@@@@@@@@@@@@@@@@@@@@@@@@@@@@@@@@@@@@@@@@@@@@@@@@@@@@@@@@@@@@@@@@@@@@@@@@@@@@@@@@@@@@@@@%%@@@%%@@.:::::::::::::::::::::::::::.@*@@@#@@.....@..@#***##%#.@*....@@#@@@@@.:::::::::::.
-%%%@@@@@@@@@@@@%%%%%@@@@@@@@@@@@@@@%%%%%@@@@@@@@@@@@@@@@%%%%%@@@@@@@@@@@@%%%%%@@@@@@@@%%%%%@@@@@@@@@@@@@@@@%%%%%@@@@@@@@@@@@@@@@@@%%%%%@@@@@@@@@@@@@@@@@@%%%%%@@@@@@@@@@@@%%%%%%@@.:::::::::::::::::::::::::::.@@@%*+-::+**-@.@@@@@@@@@@.@#=*+---+*@@@@.:::::::::::.
-%%%@..........@%%%%%@.............@%%%%%@..............@%%%%%@.........-@%%%%%@......@%%%%%@..............@%%%%%@................@%%%%%@................@%%%%%@:.........@%%%%%%@*.:::::::::::::::::::::::::::.@.--+++**##*+-...............::.......:@.:::::::::::.
-%%%@@@@@@@@@@@@%%%%%@@@@@@@@@@@@@@@%%%%%@@@@@@@@@@@@@@@@%%%%%@@@@@@@@@@@@%%%%%@@@@@@@@%@@@%@@@@@@@@@@@@@@@@%%%%%@@@@@@@@@@@@@@@@@@%%%%%@@@@@@@@@@@@@@@@@@%%%%%@@@@@@@@@@@@%@@@%%@@.:::::::::::::::::::::::::::.=.@-.........#@@@@@@@@@@@@@@@@@@@@@@@@...:::::::::::.
@@@@@@@@@@@@@@@@@@@@@@@@@@@@@@@@@@@@@@@@@@@@@@@@@@@@@@@@@@@@@@@@@@@@@@@@@@@@@@@@@@@@@@%%@*%@%%@@@@@@@@@@@@@@@@@@@@@@@@@@@@@@@@@@@@@@@@@@@@@@@@@@@@@@@@@@@@@@@@@@@@@@@@@@@@%%@.@%%@@.:::::::::::::::::::::::::::....@@@@@%@@@#@@*#*####*#+@#%@@+@@@=@@...::::::::::::.
.....................................................................................@%%@..@%%@..........................................................................@%%@.@%%@@.::::::::::::::::::::::::::::::.@..*@.*+@.@#+###**###*%:.@@..@@..@.::::::::::::::.
.:::::::::::::::::::::::::::::::::::::::::::::::::::::::::::::::::::::::::::::::::::.@%%@.-@%%@..::::::::::::::::::::::::::::::::::::::::::::::::::::::::::::::::::::::..@%%@.@%%@@.::::::::::::::::::::::::::::::.@.#=@.@%@.@%*##*##*###@*.@@-.@@.-@.::::::::::::::.
.:::::::::::::::::::::::::::::::::::::::::::::::::::::::::::::::::::::::::::::::::::.@%%@.-@%%@..::::::::::::::::::::::::::::::::::::::::::::::::::-:::::::::::::::::::..@%%@.@%%@@.::::::::::::::::::::::::::::::.@.@.@.@.@.@@%+--::::-+@*.@@-.@@.-@.::::::::::::::.
.:::::::::::::::::::::::::::::::::::::::::::::::::::::::::::::::::::::::::::::::::::.@%%@.-@%%@..::::::::::::::::::::::::::::::::::::::::::::::::::=:::::::::::::::::::..@%%@.@%%@@.::::::::::::::::::::::::::::::.@.@.@.@.@.@..@@@@@@@@-@*.@@-.@@.-@.::::::::::::::.
.:::::::::::::::::::::::::::::::::::::::::::::::::::::::::::::::::::::::::::::::::::.@%%@..@%%@..:::::::::::::::::::::::::::::::::::::::::::::::::.+.::::::::::::::::::..@%%@.@%%@@.::::::::::::::::::::::::::::::.@.@.@.@.@.@-.#%*#@%*@:@#.@@-.@@.-@.::::::::::::::.
.:::::::::::::::::::::::::::::::::::::::::::::::::::::::::::::::::::::::::::::::::::.@%%@@@@%%@..:::::::::::::::::::::::::::::::::::::::::::::::::.*.::::::::::::::::::..@%%@.@%%@@.::::::::::::::::::::::::::::::.@.@.@.@.@.@=.@@#+@+%@.@#.@@=.@@.-@.::::::::::::::.
.:::::::::::::::::::::::::::::::::::::::::::::::::::::::::::::::::::::::::::::::::::.@%%%%%%%%@..::::::::::::::::::::::::::::::::::::::::::::::::..-..:::::::::::::::::..@%%@@@%%@@.::::::::::::::::::::::::::::::.@.@.@.@.@.@=.@@#*@++@.-%.@@+.@@.-@.::::::::::::::.
.:::::::::::::::::::::::::::::::::::::::::::::::::::::::::::::::::::::::::::::::::::.@%%%%%%%%@..::::::::::::::::::.....:-:::::::::::::::::::::::.@@..:::::::::::::::::..@%%%%%%%@@.:::::::::::::::::::::::::::::..-...@.=.@.@..-+-:#::@....#...*...@..:::::::::::::.
.:::::::::::::::::::::::::::::::::::::::::::::::::::::::::::::::::::::::::::::::::::.@%%@@@@%%@..:::::::::::::::::..*++=.:::::::::::::::::::::::..##%.:::::::::::::::::..@%%%%%%%@@.:::::::::::::::::::::::::::::.@@@@@@@@@@@@@@@@@@@@@@@@@@@@@@@@@@@@.:::::::::::::.
.:::::::::::::::::::::::::::::::::::::::::::::::::::::::::::::::::::::::::::::::::::.@%%@..@%%@..:::::::::::::::::.@%==@::::::::::::::::::::::::.-#@@..::::::::::::::::..@%%@@@%%@@.:::::::::::::::::::::::::::...@..................................@...:::::::::::.
.:::::::::::::::::::::::::::::::::::::::::::::::::::::::::::::::::::::::::::::::::::.@%%@.-@%%@..:::::::::::::::::.#+%%@.::::::::::::::::::::::..@:.@*.::::::::::::::::..@%%@.@%%@@.:::::::::::::::::::::::::...@......................................@...:::::::::.
.:::::::::::::::::::::::::::::::::::::::::::::::::::::::::::::::::::::::::::::::::::.@%%@.-@%%@..:::::::::::::::::.+#=+@.:::::::........:::::::.+@@@@@.::::::::::::::::..@%%@.@%%@@.:::::::::::::::::::::::::.@@@@@@@@@@@@@@@@@@@@@@@@@@@@@@@@@@@@@@@@@@@@.:::::::::.
.:::::::::::::::::::::::::::::::::::::::::::::::::::::::::::::::::::::::::::::::::::.@%%@.-@%%@..:::::::::::::::::.##+=@.:::::::.#*-::#:........@*::+@.::::::::::::::::..@%%@.@%%@@.:::::::::::::::::::::::::.@........................................:*@.:::::::::.
.:::::::::::::::::::::::::::::::::::::::::::::::::::::::::::::::::::::::::::::::::::.@%%@.-@%%@..:::::::::::::::::.=@@+@.:::::::.#@@@@@.:------.@#==%@.::::::::::::::::..@%%@.@%%@@.:::::::::::::::::::::::::..............................................:::::::::.
.:::::::::::::::::::::::::::::::::::::::::::::::::::::::::::::::::::::::::::::::::::.@%%@..@%%@..:::::::::::::::::.@@@.@.:::::::.*#..:..:==-=--.*@*+=*..:::::-:::::::::..@%%@.@%%@@..................................................................................
.:::::::::::::::::::::::::::::::::::::::::::::::::::::::::::::::::::::::::::::::::::.@%%@@@@%%@..:::::::::::::::::........::::::.+#*@@+.........@+..=@@....::::::::::::..@%%@.@%%@@=@@@@@@@@@@@@@@@@@@@@@@@@@@@@@@@@@@@@@@@@@@@@@@@@@@@@@@@@@@@@@@@@@@@@@@@@@@@@@@@@.
.:::::::::::::::::::::::::::::::::::::::::::::::::::::::::::::::::::::::::::::::::::.@%%%%%%%%@..:::::::::::::::::.@@@@@..::::::.*%*@@-..@@@@@@=*##%-+..@+....:::::::::..@%%@@@%%%@@@@@@@@@@@@@@@@@@@@@@@@@@@@@@@@@@@@@@@@@@@@@@@@@@@@@@@@@@@@@@@@@@@@@@@@@@@@@@@@@@#
.:::::::::::::::::::::::::::::::::::::::::::::::::::::::::::::::::::::::::::::::::::.@%%%%%%%%@..:::::::::::::::::.@*%:@.....:...:++@@.+@::@@.#+.-...@@-=.@@:.-::::::::..@%%%%%%@@@@@@@@@@@@%%%%%@@@@@@@@@@@@@@@@@@%%%%%@@@@@@@@@@@@@@@@%%%%%%@@@@@@@@@@@@@@@%%%%%@@@
.:::::::::::::::::::::::::::::::::::::::::::::::::::::::::::::::::::::::::::::::::::.@%%@@@@%%@..::::::::::::......+:+@@@@@@...#:*:::+:-@.-@@.*%:@@@@@%@@@@@%.-::::::::..@%%%%%%@..........@%%%%%@*...............@%%%%%@..............@%%%%%%@............*@%%%%%@..
.:::::::::::::::::::::::::::::::::::::::::::::::::::::::::::::::::::::::::::::::::::.@%%@..@%%@..::::::::::::.@@@@@@+-.-.::#...@@@@@@::#@.....=@==..-.........:::::::::..@%%@@@%@@@@@@@@@@@@%%%%%@@@@@@@@@@@@@@@@@@%%%%%@@@@@@@@@@@@@@@@%%%%%%@@@@@@@@@@@@@@@%%%%%@@@
.:::::::::::::::::::::::::::::::::::::::::......::::::::::::::::::::::::::::::::::::.@%%@.-@%%@..::::::::::::..@=@@.+@-%:@+@...%.==.:=:*@.-@@.*@=%@@@+@@@@@@:.:::::::::..@%%@.@%%@@@@@@@@@@@@@@@@@@@@@@@@@@@@@@@@@@@@@@@@@@@@@@@@@@@@@@@@@@@@@@@@@@@@@@@@@@@@@@@@@@@@
.:::::::::::::::::::::::::::::::::::::.....:++:.....::::::::::::::::::::::::::::::::.@%%@.-@%%@..::::::::::::.:@*@@.--...=.*...@=##+==:.%.-@@.+-.%.........:..:::::::::..@%%@.@%%@@..................................................................................
.::::::::::::::::::::::::::::::::::::..=@@@%##%@@@=..:::::::::::::::::::::::::::::::.@%%@.-@%%@..::::::::::::.......#@@@@@@@:..@:::=-%..+..-:..-.==+%:.=..:::.:::::::::..@%%@.@%%@@.::::::::::::::::::::::::::::::::::::::::::::::::::::::::::::::::::::::::::::::::.
.::::::::::::::::::::::::::::::::::..-@#+=====+=+*#@-..:::::::::::::::::::::::::::::.@%%@.-@%%@..::::::::::::.#@+*@=#@..*..@...@+@@=:@@@@@@@@@@@@@@@@@@.@@.@-.:::::::::..@%%@.@%%@@.::::::::::::::::::::::::::::::::::::::::::::::::::::::::::::::::::::::::::::::::.
.::::::::::::::::::::::::::::::::::.*%*====+++=====*%=.:::::::::::::::::::::::::::::.@%%@.-@%%@..:::::::::::...@@#@*=@*@@==@...@+@@=-@.=+:*@@+=*.:==:@@.@@.@@..::::::::..@%%@.@%%@@.::::::::::::::::::::::::::::::::::::::::::::::::::::::::::::::::::::::::::::::::.
.::::::::::::::::::::::::::::::::::.@+===+++-***=+==*@..::::::::::::::::::::::::::::.@%%@..@%%@..:::::::::::.:....#.:=:=+**@.-:*::.:...-*..:-.:+.===:@@....@#.-.:::::::..@%%@.@%%@@.::::::::::::::::::::::::::::::::::::::::::::::::::::::::::::::::::::::::::::::::.
.:::::::::::::::::::::::::::::::::.:@==++++#:-.-+=+++@..........::::::::::::::::::::.@%%@@@@%%@..:::::::::::.@#==:=:=--::::++%+*=+=+===-=:=:-:=-----:..==+:::%@.:::::::..@%%@.@%%@@.::::::::::::::::::::::::::::::::::::::::::::::::::::::::::::::::::::::::::::::::.
.::::::::::::::::::::::::::::::.....@++==*.#-:%*+++=+@...#@@@@@...::::::::::::::::::.@%%%%%%%%@..:::::::::::.@@@@@@@@@@@@@@@@@@@@@@@@@@@@@@@@@@@@@@@@@@@@@@@@@@.:::::::..@%%@.@%%@@.::::::::::::::::::::::::::::::::::::::::::::::::::::::::::::::::::::::::::::::::.
.::::::::::::::::::::::::::.........+#+++++%..@*=.++#+.@@#+=++*%@..:::::::::::::::::.@%%%%%%%%@..:::::::::::....................................................:::::::..@%%@*@%%@@.::::::::::::::::::::::::::::::::::::::::::::::::::::::::::::::::::::::::::::::::.
.:::::::::::::::::::::::::..%@@@@@@@.-%*+==@..+.++#@%.%#++=*=*+=*@.:::::::::::::::::.@%%@@@@%%@..::::::::::::::::::::::::::::::::::::::::::::::::::::::::::::::::::::::..@%%@@@%%@@.::::::::::::::::::::::::::::::::::::::::::::::::::::::::::::::::::::::::::::::::.
.::::::::::::::::::::::::..@#+=+**+*#=.@@@#@..@@@@@...@+==+#.:+=+@:.::::::::::::::::.@%%@..@%%@..::::::::::::::::::::::::::::::::::::::::::::::::::::::::::::::::::::::..@%%%%%%%@@.::::::::::::::::::::::::::::::::::::::::::::::::::::::::::::::::::::::::::::::::.
.::::::::::::::::::::::::.+%=++#.=-++@....-#..%-....:.@#==+-.@*-*@..::::::::::::::::.@%%@.:@%%@..::::::::::::::::::::::::::::::::::::::::::::::::::::::::::::::::::::::..@%%@@@%%@@.::::::::::::::::::::::::::::::::::::::::::::::::::::::::::::::::::::::::::::::::.
.::::::::::::::::::::::::.-%++-=.@++*@.::...@@...::::..@%#*%.:#%@..:::::::::::::::::.@%%@.-@%%@..::::::::::::::::::::::::::::::::::::::::::::::::::::::::::::::::::::::..@%%@.@%%@@.::::::::::::::::::::::::::::::::::::::::::::::::::::::::::::::::::::::::::::::::.
.:::::::::::::::::::::::::.@@###.*-%@:.:::..@@.:::::::...%@*.@@...::::::::::::::::::.@%%@.-@%%@..::::::::::::::::::::::::::::::::::::::::::::::::::::::::::::::::::::::..@%%@.@%%@@.::::::::::::::::::::::::::::::::::::::::::::::::::::::::::::::::::::::::::::::::.
.:::::::::::::::::::::::::...%@#.@@-..::::..@@..::::::::...+%...::::::::::::::::::::.@%%@.-@%%@..::::::::::::::::::::::::::::::::::::::::::::::::::::::::::::::::::::::..@%%@.@%%@@.::::::::::::::::::::::::::::::::::::::::::::::::::::::::::::::::::::::::::::::::.
.:::::::::::::::::::::::::::....@...........#%.............%@.::::::::::::::::::::::.@%%@.-@%%@..::::::::::::::::::::::::::::::::::::::::::::::::::::::::::::::::::::::..@%%@.@%%@@.::::::::::::::::::::::::::::::::::::::::::::::::::::::::::::::::::::::::::::::::.
.:::::::::::::::::::::::::::::.:@...=#@@@@@%**%@@@@@@@@%*=.#@.....::::::::::::::::::.@%%@..@%%@..::::::::::::::::::::::::::::::::::::::::::::::::::::::::::::::::::::::..@%%@.@%%@@.::::::::::::::::::::::::::::::::::::::::::::::::::::::::::::::::::::::::::::::::.
.:::::::::::::::::::::::::::...:%@@%#*+++#%%@@%%#*+++=+*###**%@@@.::::::::::::::::::.@%%@@@@%%@..::::::::::::::::::::::::::::::::::::::::::::::::::::::::::::::::::::::..@%%@.@%%@@.::::::::::::::::::::::::::::::::::::::::::::::::::::::::::::::::::::::::::::::::.
.::::::::::::::::::::::::::..#@#++#%@@%*=.........:==+=======*%#..::::::::::::::::::.@%%%%%%%%@..::::::::::::::::::::::::::::::::::::::::::::::::::::::::::::::::::::::..@%%@.@%%@@.::::::::::::::::::::::::::::::::::::::::::::::::::::::::::::::::::::::::::::::::.
.::::::::::::::::::::::::::.@#++#@+.....=##%@@%%#**++=====++#@:..:::::::::::::::::::.@%%%%%%%%@..::::::::::::::::::::::::::::::::::::::::::::::::::::::::::::::::::::::..@%%@@@%%@@.::::::::::::::::::::::::::::::::::::::::::::::::::::::::::::::::::::::::::::::::.
.::::::::::::::::::::::::::.@++%....@@@#*+===============+#%@..:::::::::::::::::::::.@%%@@@@%%@..::::::::::::::::::::::::::::::::::::::::::::::::::::::::::::::::::::::..@%%%%%%%@@.::::::::::::::::::::::::::::::::::::::::::::::::::::::::::::::::::::::::::::::::.
.::::::::::::::::::::::::::.@*++...@#+======++=++======*%@@...::::::::::::::::::::::.@%%@..@%%@..::::::::::::::::::::::::::::::::::::::::::::::::::::::::::::::::::::::..@%%%%%%%@@.::::::::::::::::::::::::::::::::::::::::::::::::::::::::::::::::::::::::::::::::.
.::::::::::::::::::::::::::.-@#%...+@%*+===+==++==++#@@@:...::::::::::::::::::::::::.@%%@.-@%%@..::::::::::::::::::::::::::::::::::::::::::::::::::::::::::::::::::::::..@%%@@@%%@@.::::::::::::::::::::::::::::::::::::::::::::::::::::::::::::::::::::::::::::::::.
.:::::::::::::::::::::::::::..%@@@....@@@@@@@@@@@@@@+....:::::::::::::::::::::::::::.@%%@.-@%%@..::::::::::::::::::::::::::::::::::::::::::::::::::::::::::::::::::::::..@%%@.@%%@@.::::::::::::::::::::::::::::::::::::::::::::::::::::::::::::::::::::::::::::::::.
.::::::::::::::::::::::::::::.....:-:.................::::::::::::::::::::::::::::::.@%%@.-@%%@..::::::::::::::::::::::::::::::::::::::::::::::::::::::::::::::::::::::..@%%@.@%%@@.::::::::::::::::::::::::::::::::::::::::::::::::::::::::::::::::::::::::::::::::.
.....................................................................................@--%..#--@..........................................................................@--@.@--*...................................................................................